NO ./textures/redbrick.png
SO ./textures/redbrick.png
WE ./textures/redbrick.png
EA ./textures/redbrick.png
F 220,100,0
C 225,30,0

1111111111
 100001111
  10100111
   1000N11
    111111
