NO ./textures/redbrick.png
SO ./textures/redbrick.png
WE ./textures/redbrick.png
EA ./textures/redbrick.png
F     220,100, 123
C     225,30, 123

11111
11011
10N0
11011
11011
11111
