NO ./textures/redbrick.png
SO ./textures/redbrick.png
WE ./textures/redbrick.png
EA ./textures/redbrick.png
F     220,100, 123
C     225,30, 123

   111111111
   100000011
   100111011
111N001 101
1000001 101
1111111 101
1111111
