NO ./textures/redbrick.png
SO ./textures/redbrick.png
WE ./textures/redbrick.png
EA ./textures/redbrick.png
F 220,100,123
C 225,30,123

111111
100001
101001
1000N1
111111
